222222222222222222222222
200000000000000000000002
200000000000000000000002
200000000000000000000002
200000200020000000000002
200000200020000200020002
200000200020000000000002
222222222000000000002002
200000000000000000000002
220000000000000000002002
200000000000000000000002
200000000000000000000002
200000000000000000000002
200000000000000000000002
200000000000000000000002
222222222000000000000002
200000002200000202020002
200000002220000202020002
200000003200000002000002
200000002200000002000002
200000222000000000000002
200000000000000000000002
222222222222222222222222
